11111111111111111111111111111111111
1C00000000000000011C000100000000001
100P0000000000000000000111111111111
10C000000E0000000C00000000000000001
11111111111111111111111111111111111