11111111111111111111111111111111111
1C00000000000000011C000100000000001
100P0000000000000000000111111111111
10C00000000000000C00000100E00000001
11111111111111111111111111111111111