111111111111111111111111111111111111111111111111111111111111111111111111111111111111111111111111111111
1P00000000000010010010010010010010010010010010010010010010010010010010010010010010010010010010010010E1
100000000000010000000000000000000000000000000000000000000000000000000000000000000000000000000000000001
100000000000000000000000000000000000000000000000000000000000000000000000000000000000000000000000000001
100000000000000000000000000000000000000000000000000000000000000000000000000000000000000000000000000001
100000000000000000000000000000000000000000000000000000000000000000000000000000000000000000000000000001
100000000000000000000000000000000000000000000000000000000000000000000000000000000000000000000000000001
100000000000000000000000000000000000000000000000000000000000000000000000000000000000000000000000000001
100000000000000000000000000000000000000000000000000000000000000000000000000000000000000000000000000001
100000000000000000000000000000000000000000000000000000000000000000000000000000000000000000000000000001
10000000C000000111110110110110110110110110110110110110110110110110110110110110110110110110110110110101
1C1011001110000100100100100100100100100100100100100100100100100100100100100100100100100100100100100101
111111111111111111111111111111111111111111111111111111111111111111111111111111111111111111111111111111