1111
11E1
1101
1001
1C11
1011
1011
1001
1101
11P1
1111